ww                   ww                    w
w                    w
wwwwwwwwwwwwwwwwwwwwwwwwwwwwwwwwwwwwwwwwwwww
wa                   wwa                   w
ww   a               ww			   W
w   ww  e   c  e     ww	   a               w
w       w   w  w     ww       w   w  w     w
w                    ww                    w
w    w      w w      ww    w      w w      w
w      www          wwwww    www           w
w                      			   W
wb p     	                 wd        w
wwwwwwwwwwwwwwwwwwwwwwwwwwwwwwwwwwwwwwwwwwww
w                    ww                    w